c 1 1 1 p 0 0 0 0 0
0 1 0 1 1 1 e 0 0 0
0 0 0 0 0 1 0 0 0 0
1 1 1 1 1 1 c 1 0 0
1 0 0 0 0 1 0 1 1 d
e 1 1 1 0 0 0 0 0 0
1 e 0 0 0 0 0 0 0 0
0 0 0 0 0 0 0 0 0 0
0 0 0 0 0 0 0 0 0 0
0 0 0 0 0 0 0 0 0 0